# World 1-2 Underground Map - Dark Underground Theme
# Legend: # = Ground, ? = Question block, B = Brick block, M = Mario, G = Goomba, K = Koopa, - = Dark Sky

--------------------------------------------------------------------------------
--------------------------------------------------------------------------------
--------------------------------------------------------------------------------
--------------------------------------------------------------------------------
--------------------------------------------------------------------------------
--------------------------------------------------------------------------------
--------------------------------------------------------------------------------
--------------------------------------------------------------------------------
--------------------------------------------------------------------------------
--------------------------------------------------------------------------------
---------------------B-?-B-----------?-----------B-B-B-----------?-----------B-
--------------------------------------------------------------------------------
----------------------G-----------K---------G-----------K-----------G-----------
M-------------------------------------------------------------------------------
################################################################################
################################################################################
