# World 1-4 Castle Map - Dark Castle with Lava Pits
# Legend: # = Castle Floor, ? = Question block, B = Brick block, M = Mario, G = Goomba, K = Koopa, - = Dark Sky, X = Lava Pit

------------------------------------------------------------------------------------------------------------------------------------------------------------------------------------------------------
------------------------------------------------------------------------------------------------------------------------------------------------------------------------------------------------------
------------------------------------------------------------------------------------------------------------------------------------------------------------------------------------------------------
------------------------------------------------------------------------------------------------------------------------------------------------------------------------------------------------------
------------------------------------------------------------------------------------------------------------------------------------------------------------------------------------------------------
------------------------------------------------------------------------------------------------------------------------------------------------------------------------------------------------------
------------------------------------------------------------------------------------------------------------------------------------------------------------------------------------------------------
######################################################################################################################################################################################################
###################################################################---------#--------#-------------#########---------------------------######----------------------##----------------------------#####
###################################################################---------C--------S-------------#########---------------------------######----------------------##----------------------------#####
---------------------#-------------################################--------------------------------#########---------------------------######----------------------##----------------------------#####
@--------------------C------F------C----------S--------S------S------------------------------------#########---------------------------######-ZZ-------------------------------------------------#####
###----------------------------------------------------------------------------------------------------------------------------------------------------------------------------------------------#####
####---------------------------------------------------------------------------------------------------------------------------------------------------------------a-----------------------------#####
#####----------------------------##################################-----S--------S--------S----------------------------------------------------------------B-------###---------------------------#####
############XX##########XXX#S#XXX###########################################################################-----------------#####-----######======================###---------------------------#####
############XX##########XXX###XXX###########################################################################-----------------#####-----######XXXXXXXXXXXXXXXXXXXXXX###---------------------------#####
############XX##########XXX###XXX###########################################################################-----------------#####-----######XXXXXXXXXXXXXXXXXXXXXX###-----------------t---------#####
############XX##########XXX###XXX############################################################################################################XXXXXXXXXXXXXXXXXXXXXX###################################
############XX##########XXX###XXX############################################################################################################XXXXXXXXXXXXXXXXXXXXXX###################################
