# World 1-3 Tree Map - Authentic Mario Style
# Legend: # = Ground, C = Question block, B = Brick block, P = Pipe, @ = Mario, G = Goomba, k = koopa, - = Sky, X = Pit, & = Flag

------------------------------------------------------------------------------------------------------------------------------------------------------------------------------------------------------
------------------------------------------------------------------------------------------------------------------------------------------------------------------------------------------------------
------------------------------------------------------------------------------------------------------------------------------------------------------------------------------------------------------
------------------------------------------------------------------------------------------------------------------------------------------------------------------------------------------------------
------------------------------------------------------------------------------------------------------------------------------------------------------------------------------------------------------
------------------------------------------------------------------------------------------------------------------------------------------------------------------------------------------------------
-------------------------------------cc---------------------------------------------------------------------------------------------------------------------------------------------------------------
---------------------------------------------G-G---------WWWW-----------------------------------------------------------------------------------------------------------------------------------------
--------------------------ccck----------TTTTTTTT---------------cccc------------------------------cc---cc----------------------------------------------------------------------------------------------
-------------------------TTTTT---------------------------------TTTT----------K-------G---cc-----------------------------K-----------------------------------------------------------------------------
-----------------------------------------------------cc-------------------------TTTTTTT-----------------------------k---------cc--------------------%%------------------------------------------------
------------------------------------------------------------------------------------------ZZZZ---------------TTTTTTTTT------------------------------%%------------------------------------------------
-----------------------------------TTTTT---------------------------------------------------------ZZZZ---------------------------------------------%%%%------------------------------------------------
----------------------TTTTTTTTTT------------------------------F---------TTT-----------------------------------------------TTTT--TTTT--------------%%%%------------------------------------------------
-------------------------------------------------------------------------------------------------------TTTT------------ccc----------------------%%%%%%------------------------------------------------
-----------------------------------------------------------------------------------------------------------------------TTT----------------------%%%%%%------------------------------------------------
---------------------------------c--------------------------------------------------------------------------------------------------------------%%%%%%------------------------------------------------
----q----@-----TTTT-------------TTT------------------TTTT-----TTTTT-TTTT-------------------------------------------------------------------k----%%%%%%-------&--------Q-------------------------------
#############XXXXXXXXXXXXXXXXXXXXXXXXXXXXXXXXXXXXXXXXXXXXXXXXXXXXXXXXXXXXXXXXXXXXXXXXXXXXXXXXXXXXXXXXXXXXXXXXXXXXXXXXXXXXXXXXXXXXXXXXXX###############################################################
#############XXXXXXXXXXXXXXXXXXXXXXXXXXXXXXXXXXXXXXXXXXXXXXXXXXXXXXXXXXXXXXXXXXXXXXXXXXXXXXXXXXXXXXXXXXXXXXXXXXXXXXXXXXXXXXXXXXXXXXXXXX###############################################################
