# World 1-4 Castle Map - Dark Castle with Lava Pits
# Legend: # = Castle Floor, ? = Question block, B = Brick block, M = Mario, G = Goomba, K = Koopa, - = Dark eky, X = Lava Pit

------------------------------------------------------------------------------------------------------------------------------------------------------------------------------------------------------
------------------------------------------------------------------------------------------------------------------------------------------------------------------------------------------------------
------------------------------------------------------------------------------------------------------------------------------------------------------------------------------------------------------
------------------------------------------------------------------------------------------------------------------------------------------------------------------------------------------------------
------------------------------------------------------------------------------------------------------------------------------------------------------------------------------------------------------
------------------------------------------------------------------------------------------------------------------------------------------------------------------------------------------------------
------------------------------------------------------------------------------------------------------------------------------------------------------------------------------------------------------
######################################################################################################################################################################################################
###################################################################---------#--------#-------------#########---------------------------######-----------------------##---------------------------#####
###################################################################---------C--------E-------------#########---------------------------######-----------------------##---------------------------#####
---------------------#-------------################################---------------------------------------------C---C---C-------------------------------------------##---------------------------#####
@--------------------C------F------C----------e--------e------e-------------------------------------------------------------------------------ZZZ------------------------------------------------#####
###----------------------------------------------------------------------------------------------------------------------------------------------------------------------------------------------#####
####---------------------------------------------------------------------------------------------------------------------------------------------------------------a-----------------------------#####
#####----------------------------##################################-----e--------e--------e--------------------C---C---C-----------------------------------b-------###---------------------------#####
############XX##########XXX#e#XXX###########################################################################-----------------#####-----######======================###---------------------------#####
############XX##########XXX###XXX###########################################################################-----------------#####-----######XXXXXXXXXXXXXXXXXXXXXX###---------------------------#####
############XX##########XXX###XXX###########################################################################-----------------#####-----######XXXXXXXXXXXXXXXXXXXXXX###--------------&------------#####
############XX##########XXX###XXX############################################################################################################XXXXXXXXXXXXXXXXXXXXXX###################################
############XX##########XXX###XXX############################################################################################################XXXXXXXXXXXXXXXXXXXXXX###################################
