# World 1-1 Overworld Map - Authentic Mario Style
# Legend: # = Ground, C = Question block, B = Brick block, P = Pipe, M = Mario, G = Goomba, K = Koopa, - = Sky, X = Pit, F = Flag

------------------------------------------------------------------------------------------------------------------------------------------------------------------------------------------------------
------------------------------------------------------------------------------------------------------------------------------------------------------------------------------------------------------
------------------------------------------------------------------------------------------------------------------------------------------------------------------------------------------------------
------------------------------------------------------------------------------------------------------------------------------------------------------------------------------------------------------
------------------------------------------------------------------------------------------------------------------------------------------------------------------------------------------------------
------------------------------------------------------------------------------------------------------------------------------------------------------------------------------------------------------
------------------------------------------------------------------------------------------------------------------------------------------------------------------------------------------------------
------------------------------------------------------------------------------------------------------------------------------------------------------------------------------------------------------
-----BBBBBBBBBBBBBBBBBBBBBBBBBBBBBBBBBBBBBBBBBBBBBBBBBBBBBBBBBBBBBBBBBBBBBBBBBBBBBBBBBBBBBBBBBBBBBBBBBBBBBBBBBBBBBBBBBBBBBBBBBBBBBBBBBBBBBBB------------------------------####################--------
B-------------------------------------------------------BB--BBBBBBB--BBBBB------BBBB-------------------------------------------------------------------------------------########---------------------
B-------------------------------------------------------BB--BBBBBBB--BBBBB---G--BBBB------------------------------------------------------------------------------------#########---------------------
B----------------------------------------------------BB----------BB----B----BB-----------------------------------------------------------------------------------------##########---------------------
B---------------------------------------B-BBBB-B-----BB----------BB----B----BB----------BBBBB-------------------------------------------------------------------------###########---------------------
B-----------------------------C---------B-B--B-B-----BB----------BB----B-F--BB--GG------BBBBB---------------------------------------------G------BBBBB---------------############---------------------
B---------FCCCCC--------#-#-------------BBB--BBB-----BBBB----BBBBBB----BBB--BB--BBBB----------------------------PP-----------------------G##------------------------#############---------------------
B---------------------#-#-#-#---#----------------------BB-------------------------------------------------PP----PP-----------BB----------###-----------------####################--PP----PP---PP------
B-----------------G-#-#-#-#-#---#-#--------------------BB-------------------------------------------------PP----PP----PP-----BB---------####-----------------####################--PP----PP---PP-------
B@---------------G#-#-#-#-#-#-G-#-#----------KK---------------K--G-G---------------------------------G-G-GPP----PP--G-PP-----BB--------#####-------K---------####################--PP----PP---PP-----&
####################################################################################XXX####################################XX##XX###########XXXXX#######XXXXX#########################################
####################################################################################XXX####################################XX##XX###########XXXXX#######XXXXX#########################################
