# World 1-1 Overworld Map - Authentic Mario Style
# Legend: # = Ground, C = Question block, B = Brick block, P = Pipe, M = Mario, G = Goomba, K = Koopa, - = Sky, X = Pit, F = Flag

------------------------------------------------------------------------------------------------------------------------------------------------------------------------------------------------------
------------------------------------------------------------------------------------------------------------------------------------------------------------------------------------------------------
------------------------------------------------------------------------------------------------------------------------------------------------------------------------------------------------------
------------------------------------------------------------------------------------------------------------------------------------------------------------------------------------------------------
------------------------------------------------------------------------------------------------------------------------------------------------------------------------------------------------------
------------------------------------------------------------------------------------------------------------------------------------------------------------------------------------------------------
------------------------------------------------------------------------------------------------------------------------------------------------------------------------------------------------------
------------------------------------------------------------------------------------------------------------------------------------------------------------------------------------------------------
----------------------------------------TTTTTTTT------------------------------------------------------------------------------------------------------------------------------------------------------
-------------------------TTTTT----------------------------------TTT-----------------------------------------------------------------------------------------------------------------------------------
--------------------------------------------------------------------------------TTTTTTT-------------------------------------------------------------##------------------------------------------------
-------------------------------------------------------------------------------------------------------------TTTTTTTTT------------------------------##------------------------------------------------
-----------------------------------TTTTT----------------------------------------------------------------------------------------------------------####------------------------------------------------
----------------------TTTTTTTTTT----------------------------------------TTT-----------------------------------------------TTTT--TTTT--------------####------------------------------------------------
-------------------------------------------------------------------------------------------------------TTTT-------------------------------------######------------------------------------------------
-----------------------------------------------------------------------------------------------------------------------TTT----------------------######------------------------------------------------
------------------------------------------------------------------------------------------------------------------------------------------------######------------------------------------------------
@--------------TTTT-------------TTT------------------TTTT-----TTTTT-TTTT------------------------------------------------------------------------######-------&----------------------------------------
#############XXXXXXXXXXXXXXXXXXXXXXXXXXXXXXXXXXXXXXXXXXXXXXXXXXXXXXXXXXXXXXXXXXXXXXXXXXXXXXXXXXXXXXXXXXXXXXXXXXXXXXXXXXXXXXXXXXXXXXXXXX#########XXXXXXXXXXXXXXXXXXXXXXXXXXXXXXXXXXXXXXXXXXXXXXXXXXXXXX
#############XXXXXXXXXXXXXXXXXXXXXXXXXXXXXXXXXXXXXXXXXXXXXXXXXXXXXXXXXXXXXXXXXXXXXXXXXXXXXXXXXXXXXXXXXXXXXXXXXXXXXXXXXXXXXXXXXXXXXXXXXX#########XXXXXXXXXXXXXXXXXXXXXXXXXXXXXXXXXXXXXXXXXXXXXXXXXXXXXX
