# World 1-1 Overworld Map - Authentic Mario Style
# Legend: # = Ground, C = Question block, B = Brick block, P = Pipe, M = Mario, G = Goomba, K = Koopa, - = Sky, X = Pit, F = Flag

------------------------------------------------------------------------------------------------------------------------------------------------------------------------------------------------------
------------------------------------------------------------------------------------------------------------------------------------------------------------------------------------------------------
------------------------------------------------------------------------------------------------------------------------------------------------------------------------------------------------------
------------------------------------------------------------------------------------------------------------------------------------------------------------------------------------------------------
------------------------------------------------------------------------------------------------------------------------------------------------------------------------------------------------------
------------------------------------------------------------------------------------------------------------------------------------------------------------------------------------------------------
------------------------------------------------------------------------------------------------------------------------------------------------------------------------------------------------------
------------------------------------------------------------------------------------------------------------------------------------------------------------------------------------------------------
------------------------------------------------------------------------------------------------------------------------------------------------------------------------------------------------------
------------------------------------------------------------------------------------------------------------------------------------------------------------------------------------------------------
------------------------------------------------------------------------------BBBBBBB---BBBC---------------F------------BBB----BCCB-------------------------------------------------------%%----------
----------------------C------------------------------------------------------------------------------------------------------------------------------------------------------------------%%%----------
----------------------------------------------------------------------------------------------------------------------------------------------------------------------------------------%%%%----------
---------------------------------------------------------------------------------------------------------------------------------------------------------------------------------------%%%%%----------
----------------C---BFBCB--------------------------------------------------BFB-------------C-----BB-----C--C--C------B----------BB-----%--%----------%%--%------------BBCB------------%%%%%%----------
---------------------------------------------PP--------PP-----------------------------------------------------------------------------%%--%%--------%%%--%%--------------------------%%%%%%%----------
-------------------------------------PP------PP--------PP----------------------------------------------------------------------------%%%--%%%------%%%%--%%%-----PP--------------PP-%%%%%%%%----------
@---------------------G----PPG-------PP--GG--PP--------PP-------------------------------------G-G--------K-----G-G----------GG-GG---%%%%--%%%%----%%%%%--%%%%----PP-------G-G----PP%%%%%%%%%---------&
###################################################################XX###############XXX################################################################XX#############################################
###################################################################XX###############XXX################################################################XX#############################################
