# World 1-3 Tree Map - Authentic Mario Style
# Legend: # = Ground, C = Question block, B = Brick block, P = Pipe, @ = Mario, G = Goomba, K = Koopa, - = Sky, X = Pit, & = Flag

------------------------------------------------------------------------------------------------------------------------------------------------------------------------------------------------------
------------------------------------------------------------------------------------------------------------------------------------------------------------------------------------------------------
------------------------------------------------------------------------------------------------------------------------------------------------------------------------------------------------------
------------------------------------------------------------------------------------------------------------------------------------------------------------------------------------------------------
------------------------------------------------------------------------------------------------------------------------------------------------------------------------------------------------------
------------------------------------------------------------------------------------------------------------------------------------------------------------------------------------------------------
-------------------------------------cc---------------------------------------------------------------------------------------------------------------------------------------------------------------
---------------------------------------------G-G------------------------------------------------------------------------------------------------------------------------------------------------------
--------------------------cccK----------TTTTTTTT---------------cccc------------------------------cc---cc----------------------------------------------------------------------------------------------
-------------------------TTTTT---------------------------------TTTT------------------G---cc-----------------------------------------------------------------------------------------------------------
-----------------------------------------------------cc-------------------------TTTTTTT-----------------------------K---------cc--------------------##------------------------------------------------
-------------------------------------------------------------------------------------------------------------TTTTTTTTT------------------------------##------------------------------------------------
-----------------------------------TTTTT----------------------------------------------------------------------------------------------------------####------------------------------------------------
----------------------TTTTTTTTTT------------------------------F---------TTT-----------------------------------------------TTTT--TTTT--------------####------------------------------------------------
-------------------------------------------------------------------------------------------------------TTTT------------ccc----------------------######------------------------------------------------
-----------------------------------------------------------------------------------------------------------------------TTT----------------------######------------------------------------------------
---------------------------------c--------------------------------------------------------------------------------------------------------------######------------------------------------------------
@--------------TTTT-------------TTT------------------TTTT-----TTTTT-TTTT-------------------------------------------------------------------K----######-------&----------------------------------------
#############XXXXXXXXXXXXXXXXXXXXXXXXXXXXXXXXXXXXXXXXXXXXXXXXXXXXXXXXXXXXXXXXXXXXXXXXXXXXXXXXXXXXXXXXXXXXXXXXXXXXXXXXXXXXXXXXXXXXXXXXXX#########XXXXXXXXXXXXXXXXXXXXXXXXXXXXXXXXXXXXXXXXXXXXXXXXXXXXXX
#############XXXXXXXXXXXXXXXXXXXXXXXXXXXXXXXXXXXXXXXXXXXXXXXXXXXXXXXXXXXXXXXXXXXXXXXXXXXXXXXXXXXXXXXXXXXXXXXXXXXXXXXXXXXXXXXXXXXXXXXXXX#########XXXXXXXXXXXXXXXXXXXXXXXXXXXXXXXXXXXXXXXXXXXXXXXXXXXXXX
