# World 1-1 Overworld Map - Authentic Mario Style
# Legend: # = Ground, C = Question block, B = Brick block, P = Pipe, M = Mario, G = Goomba, K = Koopa, - = Sky, X = Pit, F = Flag

------------------------------------------------------------------------------------------------------------------------------------------------------------------------------------------------------
------------------------------------------------------------------------------------------------------------------------------------------------------------------------------------------------------
------------------------------------------------------------------------------------------------------------------------------------------------------------------------------------------------------
------------------------------------------------------------------------------------------------------------------------------------------------------------------------------------------------------
------------------------------------------------------------------------------------------------------------------------------------------------------------------------------------------------------
------------------------------------------------------------------------------------------------------------------------------------------------------------------------------------------------------
------------------------------------------------------------------------------------------------------------------------------------------------------------------------------------------------------
---------------------------------------------G-G------------------------------------------------------------------------------------------------------------------------------------------------------
-----------------------------K----------TTTTTTTT------------------------------------------------------------------------------------------------------------------------------------------------------
-------------------------TTTTT----------------------------------TTT------------------G----------------------------------------------------------------------------------------------------------------
--------------------------------------------------------------------------------TTTTTTT-----------------------------K-------------------------------##------------------------------------------------
-------------------------------------------------------------------------------------------------------------TTTTTTTTT------------------------------##------------------------------------------------
-----------------------------------TTTTT----------------------------------------------------------------------------------------------------------####------------------------------------------------
----------------------TTTTTTTTTT------------------------------M---------TTT-----------------------------------------------TTTT--TTTT--------------####------------------------------------------------
-------------------------------------------------------------------------------------------------------TTTT-------------------------------------######------------------------------------------------
-----------------------------------------------------------------------------------------------------------------------TTT----------------------######------------------------------------------------
------------------------------------------------------------------------------------------------------------------------------------------------######------------------------------------------------
@------------TTTTTT-------------TTT------------------TTTT-----TTTTT-TTTT-------------------------------------------------------------------K----######-------&----------------------------------------
#############XXXXXXXXXXXXXXXXXXXXXXXXXXXXXXXXXXXXXXXXXXXXXXXXXXXXXXXXXXXXXXXXXXXXXXXXXXXXXXXXXXXXXXXXXXXXXXXXXXXXXXXXXXXXXXXXXXXXXXXXXX#########XXXXXXXXXXXXXXXXXXXXXXXXXXXXXXXXXXXXXXXXXXXXXXXXXXXXXX
#############XXXXXXXXXXXXXXXXXXXXXXXXXXXXXXXXXXXXXXXXXXXXXXXXXXXXXXXXXXXXXXXXXXXXXXXXXXXXXXXXXXXXXXXXXXXXXXXXXXXXXXXXXXXXXXXXXXXXXXXXXX#########XXXXXXXXXXXXXXXXXXXXXXXXXXXXXXXXXXXXXXXXXXXXXXXXXXXXXX
