# World 1-1 Overworld Map - Authentic Mario Style
# Legend: # = Ground, C = Question block, B = Brick block, P = Pipe, M = Mario, G = Goomba, K = Koopa, - = Sky, X = Pit, F = Flag

------------------------------------------------------------------------------------------------------------------------------------------------------------------------------------------------------
------------------------------------------------------------------------------------------------------------------------------------------------------------------------------------------------------
------------------------------------------------------------------------------------------------------------------------------------------------------------------------------------------------------
------------------------------------------------------------------------------------------------------------------------------------------------------------------------------------------------------
------------------------------------------------------------------------------------------------------------------------------------------------------------------------------------------------------
------------------------------------------------------------------------------------------------------------------------------------------------------------------------------------------------------
------------------------------------------------------------------------------------------------------------------------------------------------------------------------------------------------------
------------------------------------------------------------------------------------------------------------------------------------------------------------------------------------------------------
-----BBBBBBBBBBBBBBBBBBBBBBBBBBBBBBBBBBBBBBBBBBBBBBBBBBBBBBBBBBBBBBBBBBBBBBBBBBBBBBBBBBBBBBBBBBBBBBBBBBBBBBBBBBBBBBBBBBBBBBBBBBBBBBBBBBBBBBB------------------------------####################--------
B-------------------------------------------------------BB--BBBBBBB--BBBBB------BBBB-------------------------------------------------------------------------------------########---------------------
B-------------------------------------------------------BB--BBBBBBB--BBBBB---G--BBBB---------------------------------------------------------------------vvv------------#########---------------------
B----------------------------------------------------BB----------BB----B----BB---------------------------------------------------------------^^^-----------------------##########---------------------
B---------------------------------------B-BBBB-B-----BB----------BB----B----BB----------BBBBB-------------------------------------------------------------------------###########---------------------
B-----------------------------C---------B-B--B-B-----BB----------BB----B-F--BB--GG------BBBBB---------------------------------------------G------BBBBB---------------############---------------------
B---------FCCCCC--------%-%-------------BBB--BBB-----BBBB----BBBBBB----BBB--BB--BBBB----------------------------pp-----------------------G%%------------------------#############---------------------
B---------------------%-%-%-%---%----------------------BB-------------------------------------------------pp----pp-----------BB----------%%%-----------------####################--pp----pp---pp------
B-----------------G-%-%-%-%-%---%-%--------------------BB-------------------------------------------------pp----pp----pp-----BB---------%%%%-^^^---------vvv-####################--pp----pp---pp------
B@---------------G%-%-%-%-%-%-G-%-%----------KK---------------K--G-G---------------------------------G-G-Gpp----pp--G-pp-----BB--------%%%%%-------K---------####################--pp----pp---pp-----&
####################################################################################XXX####################################XX##XX###########XXXXX#######XXXXX#########################################
####################################################################################XXX####################################XX##XX###########XXXXX#######XXXXX#########################################
