# World 1-4 Castle Map - Dark Castle with Lava Pits
# Legend: # = Castle Floor, ? = Question block, B = Brick block, M = Mario, G = Goomba, K = Koopa, - = Dark Sky, X = Lava Pit

--------------------------------------------------------------------------------
--------------------------------------------------------------------------------
--------------------------------------------------------------------------------
--------------------------------------------------------------------------------
--------------------------------------------------------------------------------
--------------------------------------------------------------------------------
--------------------------------------------------------------------------------
--------------------------------------------------------------------------------
--------------------------------------------------------------------------------
--------------------------------------------------------------------------------
----------------------------------------B-B-----------?-----------B-B-----------
--------------------------------------------------------------------------------
------------------------------G-----------K---------G-----------G-----------K---
M-----------############XXXXXXXX############XXXXXXXX############XXXXXXXX########
--------------------------------------------------------------------------------
--------------------------------------------------------------------------------
